#
# Copyright 2012 Andreas Gruber
#

#Define Lib
ullong	KEYWORD1
ulong	KEYWORD1 
long	KEYWORD1
uint	KEYWORD1
llong	KEYWORD1
pi	LITERAL1

#MotorTB6612FNG
Motor	KEYWORD1
setupMotorSTBY	KEYWORD2
motorDisableStandby	KEYWORD2
motorEnableStandby	KEYWORD2
motorDeadTimeTest	KEYWORD2
motorWriteStatus	KEYWORD2
motorMove	KEYWORD2
motorStop	KEYWORD2
motorBreak	KEYWORD2
motorWriteDriverStandby	KEYWORD2

#Voltage Divider
VoltageDivider	KEYWORD1
calculateSuplyPotential	KEYWORD2

#Wheel Rotation Sensor
WheelSensor	KEYWORD1
calculateAngleDeg	KEYWORD2
calculateAngleMilli	KEYWORD2
calculateDistance	KEYWORD2
calculateCurrentSpeed	KEYWORD2

#Servo Steering Driver
steerLeftSign	LITERAL1
steerRightSign	LITERAL1
absAngleMiddle	LITERAL1
maxAngleLeft	LITERAL1
recommendedAngleLeft	LITERAL1
maxAngleRight	LITERAL1
recommendedAngleRight	LITERAL1
ServoSteeringDriver	KEYWORD1
getMaxAngle	KEYWORD2
setSteeringAngle	KEYWORD2